Grêmio (português brasileiro) ou Grémio (português europeu) pode(m) referir-se a:
Corporação de ofício — ou guildas; associações profissionais que surgiram na Idade Média
Grêmio estudantil — organização do movimento estudantil

Clubes desportivos do Brasil
Acre
Grêmio Atlético Sampaio (Acre) — de Rio Branco
Grêmio Esportivo Acreano — de Sena Madureira
Amazonas
Grêmio Atlético Coariense — de Coari
Rio Grande do Sul
Grêmio Foot-Ball Porto Alegrense — de Porto Alegre
Grêmio Atlético Farroupilha — de Pelotas
Grêmio Esportivo Bagé — de Bagé
Grêmio Esportivo Brasil — de Pelotas
Grêmio Esportivo Fluminense — extinto; de Caxias do Sul
Grêmio Esportivo Glória — de Vacaria
Grêmio Esportivo Sapucaiense — de Sapucaia do Sul
Grêmio Esportivo Torrense — de Torres
Grêmio Esportivo Santo-angelense — extinto; de Santo Ângelo
Grêmio Foot-Ball Santanense — de Santana do Livramento
Santa Catarina
Grêmio Esportivo Comercial — extinto; de Joaçaba
Grêmio Esportivo Juventus — de Jaraguá do Sul
Grêmio Esportivo Olímpico — de Blumenau
São Paulo
Grêmio Barueri Futebol Ltda. — de Barueri
Grêmio Catanduvense de Futebol — de Catanduva
Grêmio Esportivo Catanduvense — de Catanduva, extinto
Grêmio Esportivo Mauaense — de Mauá
Grêmio Esportivo Novorizontino — de Novo Horizonte, extinto
Grêmio Esportivo Osasco — de Osasco, conhecido como GEO e Grêmio Osasco
Grêmio Esportivo Sãocarlense — de São Carlos; extinto
Grêmio Desportivo Prudente — de Presidente Prudente
Grêmio Desportivo São-Carlense — de São Carlos, fundado em 2016
Grêmio Novorizontino — de Novo Horizonte, fundado em 2010
Grêmio Olímpico de Futebol Santanense — de São José dos Campos
Grêmio Osasco Audax — de Osasco
Outros estados
Grêmio Esportivo Tiradentes — de Brasília
Grêmio Esportivo Laranjeiras — do Espírito Santo
Grêmio Esportivo Jaciara — de Mato Grosso
Grêmio Recreativo Serrano — da Paraíba
Grêmio de Esportes Maringá — do Paraná
Grêmio Mangaratibense — do Rio de Janeiro
Grêmio Atlético Sampaio — de Roraima
Grêmio Esportivo Anápolis — de Goiás; antes chamado Grêmio Esportivo Inhumense

Ver também
Todas as páginas cujo título começa por "Grêmio"
Todas as páginas que tenham "Grêmio" no título
Busca por "grêmio"
Todas as páginas cujo título começa por "Grémio"
Todas as páginas que tenham "Grémio" no título
Busca por "grémio"